452,453,454,455,456,457,452,453,454,455,456,457,452,453,454,455
516,517,518,519,520,521,516,517,518,519,520,521,516,517,518,519
1134,1134,1134,1134,1134,1134,1134,1134,1134,1134,1134,1134,1134,1134,1134,1134
302,303,1326,1326,1134,1134,1134,1134,1134,1134,1134,1134,1134,1134,1134,1134
366,367,1326,1326,1134,1134,1134,1134,1134,1134,1134,1134,1134,1134,1134,1134
1134,1134,1134,1134,1134,1134,1134,1134,1134,1134,1134,1134,1134,1134,1134,1134
1134,1134,1134,1134,1134,1134,1134,1134,1134,1134,1134,1134,1134,1134,1134,1134
1134,1134,1134,1134,1134,1134,1134,1134,1134,1134,1134,1134,1134,1134,1134,1134
1134,1134,1134,1134,1134,1134,1134,1134,1134,1134,1134,1134,1134,1134,1134,1134
