258,36,33,34,33,33,33,34,33,34,33,34,33,34,36,259
33,68,33,34,33,34,33,34,33,34,33,34,33,34,68,34
129,129,129,129,129,129,129,129,129,129,129,129,129,129,129,129
129,129,129,129,129,129,129,129,129,129,129,129,129,129,129,129
129,129,129,129,129,129,129,129,129,129,129,129,129,129,129,129
129,129,129,129,129,129,129,129,129,129,129,129,129,129,129,129
129,129,129,129,129,129,129,129,129,129,129,129,129,129,129,129
129,129,129,129,129,129,129,129,129,129,129,129,129,129,129,129
323,323,323,323,323,323,323,323,323,323,323,323,323,323,323,323
